G-Spott - Session 6
DAVID VENDETTA - LOVE TO LOVE YOU BABY
ENUR & NATASJA - CALABRIA (hoxton whores remix)
DADA & SANDY RIVERA &TRIX - LOLLIPOP
EDDIE THONEICK & BERGET LEWIS - DEEPER LOVE
DE SOUZA & SHENA - GULTY
MORANDI - LOVE ME(RADIO EDIT)
FUNKERMAN - SPEED UP
DJ ANTOINE - THIS TIME  (radio mix)
THE ADMIRALS & SERAPHINA - MANNER
VINYLSHAKERZ - Forget Me Nots (Thrust Mode Mix)
IDA CORR & FEDDE LE GRAND - LET ME THINK ABOUT IT (radio edit)
Andi Vax - The Game
Andrea - Walk On (M & C Radio Mix)
Andrea Bertolini - My Wav (Club Mix)
Antoine Clamaran & Emily Chick - Keep On Tryin' (Raw Shape Remix)
Antoine Clamaran & Frankie Goes To Holliwood - Relax (Club Mix)
Armin van Buuren & Gabriel & Dresden - Zocalo (Original Mix)
Armin van Buuren - Control Freak (Sander Van Doorn Remix)
Ashlee Simpson - L.O.V.E. (Kiss FM Jalsamino Mix)
Asle - Golden Sun (Seamus Haji & Emanuel Remix)
ATB - Believe In Me
ATB - Inten City (New Clubb Mix)
Avalon Superstar - All Of My Love (Soul Seekerz Remix)
Axer - 12
Axwell & Sebastian Ingrosso - Together (Radio Edit)
Axwell & Steve Angello - Why
Axwell - Feel The Vibe (Til The Morning Comes) (Vocal Radio Mix)
Beatfreakz - Somebody's Watching Me (Ian Carey Remix)
Belle Epoque - Miss Broadway (Ian Carey Mix)
Ben Delay - Hide The Pain
Benassi Bros. feat. Sandy - Feel Alive
Benedict Szlagowski - Shakedown
DJ LHASA - REGGIO CALABRIA
E - ROCKERZ - HEY BOY HEY GIRL
GIANNY PELLEGRINO - TRANCE DELIRIUM
SPENSER & HILL - GET IT ON
G-SPOTT - SADNESS
DJ JIM - ELECTRO SPEED
SANDER KLEINENBERG - THIS IS MIAMI
Dj Jose - Dedication (electro mix)
Ame - Rej (Original Mix)
ATB - Let U Go (2006 Reworked) (New Airplay Mix)
Beyonce feat. Jay-Z - &eja Vu (Freemasons Radio Mix)
Carla Vallet - Streets Of Tomorrow
Coburn - We Interrupt This Program (Ledge Bold Remix)
Deep Dish - Say Hello (Steve Angello & Sebastian Ingrosso Remix)
DJ Antoine vs. Mad Mark - Take Me Away (Chriss Ortega And Thomas Gold Mix)
Dj Ross vs. Dy - Beat Goeas On (In Da Club Mix)
Dj Tapolsky & Red Co & Alexa - До Зірок
Fall Out Boy - Dance Dance (Tommie Sunshine's Radio Edit)
Blank & Jones - Catch (Martin Roth Remix)
Bob Sinclar - Love Generation (Hans Chadrick Lovely Remix)
Bob Sinclar - Rock This Party (London 909's Dub Mix)
Bob Sinclar feat. Steve Edwards - World Hold On (Axwell Remix)
Bobina feat. Elles De Graaf - Lighthouse
Body Rockers - I Like The Way (Junior Jack Rock Da House Club Mix)
Bush II Bush - Piano Track (Mync Projects Balls II Bush Remix)
Butcher & Nicholls - Sex (NtbsDMain Mix)
Cafe Groove - Why U Wanna Do Me Wrong (Roby Arduini Mix)
Candy Williams - You Got The Music (Milk & Sugar Remix)
Cassius - Toop Toop (Olivier Koletski Mix)
Chicane & Tom Jones - Stoned In Love
Chocolate - Can't Get Enough (Vocal Mix)
Chris Lake - Release (Original Mix)
ChrissǖOrtega & Thomas Gold - African Experience (Hot Mix)
City Zen feat. Katrin Vesna - Луна
Club - Deep Inside (Thomas Gold And Eric Smax)
Club House - Don't Stand So Close To Me (Joykitikonti Mix)
Club House - Speed Of Sound
Club Scene Investigators - Direct Dizko (Sander Van Doorn Remix)
Coldplay - Talk (Spencer Collective Main Mix)
D-Deejay And Insomnia Sound - Coronita (Guitar Rhytm) (Radio Edit)
D-Ramirez & Anton Neumark - Satisfaction Generation
D.S. Jones - I Feel Me (Dj Pedro Hurricane Mix)
Darude - Sandstorm 200  (Dallas Superstars Remix)
David Guetta & The Egg - Love Don't Let Me Go (Walking Away)
David Guetta - The World Is Mine (Antoine Clamaran Remix)
David Guetta feat. Jd Davis - In Love With Myself (Benny Benassi Remix)
Dawn - Lovin' or Leavin' (Original Edit)
DCX - Flying High (Cid Inc. Remix)
Deep Dish - Sacramento (Raul Rincon Remix)
Deepgroove - Jus Luv Bass (Yer Man Remix)
Denis Dynamite - One Day Without You (Radio Edit)
Depeche Mode - Precious (Commuter Mix)
Depechǖ Mode - Suffer Well (Narcotic Thrust Vocal Dub)
Di Miro - Crossing The Universe (Extended Mix)
Diego Ray pres. Disco Train - Let The Deejay (Original Mix)
Dina Vass & Association - Let You Get Away (Original Mix)
Disco Indulgence - Can't Get Enough
Discoaction - Be Free (Rokwell Remix)
Discoheadz feat. Sean Finn - Skynight (Danny Wild Remix)
DJ Antoine - All We Need (Sandy Vee Wilhem Make U Know Mix)
DJ Disciple - Yes (Ian Carey Dub Mix)
Dj Electric - Trino
DJ Jean - Feel It
Dj Mr. Chrixx feat. Morris - Got To Let You Know (Savier's Club Mix)
Dj Natasha Rostova - Heart Beat (Extented Mix)
Dj Pilot - Crash My Heart (Radio Edit)
DJ Prom - Slow It Down (Original Dub Mix)
Dj R-Tem feat. Ben Lost - Green And Red (Radio Mix)
Dj Ralph & JO - To The Limits (Dj Sender Remix)
DJ Renat - Night Express (Dub Mix)
Dj Romeo & Dj Matiz - Закрой Глаза
DJ Sammy - Place On Fire
Dj Sender - What You Need (Dj Prom House Mafia Holla Mix)
Dj Sender - Гимн Kiss FM
DJ Sergeev - Dj Superstar (International Radio Mix)
Dj Slava Flash - У Києвi Нуль Годин (Radio Edit)
DJ Slava Flash - Украина (Da Rock's Massive Radio Mix)
Dj Slava Flash feat. Nataly - Hot Sammer (Radio Edit)
DJ Slava Flash vs. DJ Dynamite - Nu Tech (Club Mix)
DJ Sneak - Funky Rhythm (Tune Brothers Remix)
DJ Stranger - Requiem For A Drea
Dj Tapolsky & Red Co & Alexa - Время Солнце
Dj Tapolsky - Весняний Ранок
Dj Tiesto & Maxi Jazz - Dance4life (Radio Edit)
DJ Бойко & Sound Shocking - Глубоко
DJ Бойко & Sound Shocking - Трава
Duderstadt - Mahananda (Original Mix)
Eddie Thoneick & Bonse - Together As One (Vocal Mix)
Electro Bang - Intensive Trippin'
Eric Prydz vs. Pink Floyd - Proper Education (Original Mix)
Eric Smax & Claude Monette - Maybe Your Heart
Eurythmics - Sweet Dreams (Are Made Of This) (Steve Angello Bootleg)
Evermore - It's Too Late (Dirty South Remix)
Fastlem - Stop The Rock (Promo Mix 2)
Ferry Corsten - Fire (Radio Edit)
Ferry Corsten - Junk (D Ramirez Mix)
Ferry Corsten - Watch Out
Filterfunk - S.O.S. (Message In A Bottle) (Hi-Tack Mix) (Radio Edit)
First Optional Deal - Stockholm 2 Paris
Fischer Spooner - Never Win (Benny Benassi Remix)
Freddy Mercury - Love Kills (Rank 1 Radio Mix)
Frederik - House Gy
Freemasons feat. Amanda Wilson - Watchin' (Dub Mix)
Gabriel & Dresden - Let Go
Gabriel & Dresden feat. Molly - Tracking Treasure  own
Gnarls Barkley - Crazy (2Special & DJ Slim Disco Mix) (Radio Edit)
Granite And Phunk - Fallen Love (John Dahlbaeck Remix)
Granite And Phunk - Make Me Feel (Original Mix)
Granite And Phunk - My Heart (Seamus Haji & Paul Emanuel Remix)
Granite And Phunk feat. Angie B - Switch On Push Play (DJ Prom Mix)
Granite And Phunk feat. Angie B - Switch On Push Play (Dj Sender Freaking Dub Mix)
Greg Di Mano vs. Tim B. - Barcelona (Ian Carey Remix)
Gtr - Cops (Ali Wilsons Tekelec Remix)
Hi-Tack - Say, Say, Say (Waiting 4 You)
Housetrap & Dave Kane - Freak
Inner City Playboys - Jetsetter (Ian Carey Remix)
Integration - Rules Of Attraction (Radio Mix)
Istar project - Гимн Kiss FM (Serge D. Remix)
Istar project feat. Lena Boo - Once More
Ivan Demsoff - Chicago
Jd Davis & Yves Larock - Losing Track Of Time (Original Club Mix)
Jealous Guys - Mr. Brightside (Club Edit)
Jerry Ropero & Denis The Menace pres. Sabor feat. Jaqueline - Coracao (Club Mix)
Johan Gielen - Physical Overdrive (Radio Edit)
Johnny & Peps - Freedom In My House (Noize Mix)
Joonas Hahmo - The Fusion (Hawk Remix)
Judge Jules & Cara Dillo - Ordinary Day (Radio Edit)
Jupiter Ace feat. Shena - 1000 Years (Just Leave Me Now)
K'maro - Sous L'oeil De L'ange (2Special Remix)
Karen Overton - Your Loving Arms (Damien Heck Remix)
Kevin Sunray - Heart Of Africa
Kortezman feat. Rozalla - Everybodys Free (Hernandez vs. Djtyo Free Club Remix)
La Griffe - Make It Shine
Late Night Alumni - Empty Streets (Seamus Haji & Paul Emmanuel Remix)
Les Rythmes Digitales - Jacques Your Body
LMC - You Get What You Give (Melody Masters Remix)
Locktown & Alexandra Prince - Alive
Loletta Holloway - Love Sensation (Hi-Tack Burnin' Up Radio Mix)
Lorraine - Transatlantic Flight (Axwell Mix)
Macca & Mel Sweet - I'd Rather Be Alone (Dub Mix)
Madonna - Get Together (Hitmixers Remix)
Madonna - Hung U
Madonna - Sorry (Man With Guitar Mix)
Marco V - Arpanet (Vision Remix)
Martin H - Rebells Yell
Martin Solveig - Everybody (Ledge Bold Remix)
Martin Solveig - Jealousy (Junior Jack Mix)
Mashtronic - Different Feeling (Radio Mix)
Mashtronic feat. Matthew Bradley - Supernova (Original Mix)
Massimo Padovani - Blue Noise
Matias Lehtola & Gina J - Bourning Bright
May & Marion - Higher (Robbie Rivera Vocal Mix)
Melba Moore - My Heart Belongs To You (Dj Prom Mix)
Memi P. pres. Havana 7 Meet Martha Wash - Catch The Light
Milk & Sugar - Has Your Man Got Soul (Timbalestics Remix)
Moby - Slipping Away (Axwell Vocal Mix)
Modjo - Lady (Erick Morillo vs. Who Da Funk Mix)
Molella - From Space To My Life (Alex Gaudino Remix)
Moony - For Your Love
Moussa Clarke pres. Gambit - Fade Away (Lebedev Mix)
Mr. Gee - Forever (Radio Edit)
Mr. Groove & Vergas - Just The Way I Like It (Giuseppe Ottavia i Remix)
Muttonheads - I'll Be There (Raul Rincon Remix)
Narcotic Thrust - Waiting For You (Vocal Mix)
Neo Tokyo - All Trnst Is Gone (Radio Mix)
New Order - Guilt Is A Useless Emotion (Dj Dan Club Mix)
Noferini & Jack In The City - C'mon (D.O.N.S. Remix)
Ns Connexxion - Freak U Up (Joia Dub Mix)
Nuances & Linda Lee Hopkins - I Feel Love
Oliver Moldan - From The Stars (Second Session) (DJ Sender Remix)
Omaha & Fiona Holt - You Came Into My Life (Narcotic Thrust Club Mix)
One Hit Wonders - Grace Of God (Rhythm Code Mix)
Open Air & Gram'ma Funk - Hi Roller
Optik - Claim (Original Miǖ)
Pakito - Living On Video
Pakito - Moving On Stereo
Paul Oakenfold &  Pharrell Williams - Sex N Money
Pavliga - Горизонт (Radio Edit)
Pet Shop Boys - Minimal (Tocadisco's Sunday At Space Mix)
Pete Tong & Chris Cox feat. Sk8 - Deep End (Alex Gaudino & Jerma Remix)
Phats & Small - It's A Beautiful Day (Vocal Mix)
Phunk Investigation - You Don't Fool Me (G-Men Locomotive Remix)
Pink - U And Ur Hand (Bimbo Jones Remix)
Pink - Who Knew (Bimbo Jones Radio Edit)
Planet Funk - Chase The Sun (Hank Scorpio Remix)
Platinum Project - Love Is The Drug (Dj Prom Mix)
Poppers 2 - Latest
Private Tools - Rising
Raul Rincon - Indigenous People (Body)
Raw Shape - Come Back
Re Locate - Rogue
Robbie Williams - Feel (Remix)
Roger Sanchez feat. GTO - Turn On The Music (Chriss Ortega & Thomas Gold Remix)
Roger Sanchez feat. Lisa Pure ǖ Lost (Tom De Neef's Vocal Remix)
Royksopp - What Else Is There (Thin White Duke Mix)
Samba 2006 - Samba De Janeiro 2006 (John Acquaviva Remix)
Scape - Be My Friend (Ian Carey Vocal Mix)
Scissor Sisters - Laura (Kiss FM Jalsomino Mix)
Scooter - Apache Rocks The Bottom (Radio Mix)
Sex Machine & Shena - Friday Night (Ian Carey Vocal Remix)
Shannon - Let The Music Play (DJ Mawrick Breakz Mix)
Shapeshifters - Incredible (Denis the Menace & Jerry Roperos Full Vocal Mix)
Shiloh & Luke Chable - Oz
Simon & Shaker - Into The Room&(Original Mix)
Smith & Pledger pres. Aspekt - Hi Jack (Vocal Mix)
SOK DP - Жажда
Solu Music & Kimblee - Fade (Bimbo Jones Remix)
Soul Central - I Need You Now (Extended Mix)
Spanish Flies - Lost My Senses (Extended Mix)
Starlet Djs - Cant Stop Dancin' (Starlet Djs Groove Mix)
Steve Angello & Metallica - Metallica Is Dancin'
Steve Murano - Hit The Ground (Radio Edit)
Stoneface & Terminal - Venus (Original Mix)
Streamrocker meets Alexander Purkart & Gorge - Give it Up for Love (Big Room Mix)
Studio B - C'mon Get It On (Young Punx Extended Mix)
Summer Inc. - I Feel Love
Sunblock - I'll Be Ready (Dallas Superstars Club Mix)
Sunrise Electro - One Time (Radio Mix)
Supafly & Fishbowl - Let's Get Down (Full Intention Radio Edit)
Guiseppe Ottaviani - Linking People (Original Mix)
Joachim Garraud - Rock The Choice (Joachim Garraud & David Guetta Remix)
Laidback Luke & Marchand pres. Highstreets - Don't Let Go (Love De Luxe Remix)
Mariah Carey & Snoop Dogg - Say Somethin' (Stereo Anthem Mix)
Miss Distess X & Ricardo - African Dru
Nick Glamour - VIP
Pavliga & DJ Бинокль - Stay
Probspot & Ben Lost - Blows My Mind
Sean Paul - We Be Burnin' (Unknown Mix)
Spencer And Hill - Funkmaster (Club Mix)
Supafly - Moving Too Fast (Northwest Dub Mix)
Tronic Inc. - Beloved (Dj Sender Remix)
Наталья Могилевская - Давай З Тобою
Temple 1 - Silent Nature
The Drill - The Drill (Sam Malm Remix)
The Egg - Walking Away (Toscalido Remix) (Radio Edit)
The Freshmakers - Let U Go (Radio Edit)
The Migrants - I Thought that (DJ Prom Remix)
The Millionaires - Fucked Up (Redux)
The Pussycat Dolls - Buttons (Dj Shamshudinov Remix)
Till West & Dj Delicious - Same Men (Eric Smax Remix)
Timo Maas - Pictures (Paul Van Dyk Remix)
Tom Novy - Unexpected (Paul Harris Dub Mix)
Tom Novy feat. Lima - Take It (Video Edit)
tracks.txt
Way Out West - Killa (Orkidea Mix)
White Cell - Tainted Love (Original Mix)
Wonderland Avenue - White Horse (Radio Edit)
А-Студио - Улетаю (Neomaster Remix)
Алла Пугачева - 100 Друзей (Dj Lutique Mix)
Брюки - Ну
Дискотека Авария & Жанна Фриске - Малинки (Kiss FM Jalsomino Mix)
Дмитрий Филатов - Утром Я Солнце
Друга Ріка - Я П'ю З Твоїх Долонь (Istar project Remix) (Radio Edit)
Евгения Власова & Andru Donalds - Limbo
Катя Чехова - Таю (Original Mix)
НеАнгелы - Ты Из Тех Самых
НеАнгелы - Юра Прости (Kiss FM Jalsomino Mix)
Полина Гриффис - Don't Tell Me Good By
Руслана - Wild Passion (Dj Small & LV Club Mix)
Руслана - Плес
Скрябін - Старі Фотографії (Kiss FM Jalsomino Mix)
Технология - Странные Танцы (Dj Lutique Remix)
Тина Кароль - Show Me Your Love (Remix) (Radio Edit)
Тина Кароль - Выше Облаков (DJ Gans Club Remix)
Тина Чарльз - Пойдем За Мной (Агент Смит Radio Mix)
Чугунный Скороход - Реалити Шоу
Чугунный Скороход - Самолет (Original Mix)
HOXTON WHORES - FRIDAY SATURDAY LOVE (original vocal mix)
SCOOTER - LASS UNS TANZEN
TIESTO & CHRISTIAN BURNS - IN  THE DARK (radio edit)
PAKITO - ARE U READY
E-ROCKERZ - MADAN
DANCEZ - I LIKE CHOPIN (club mix)
DJ KUBRIK - LOVELUST
THE IAN CAREI PROJECT - LOVE WONT WAIT (vocal edit)
RICHARD GREY - WARPED BASS
DARKSUCKER - PURPLE MOON
SHARPHEADZ - LOUD AND CLEAR
M.I.K.E - CHANGESRGOOD
NO TONE & INUSA - Life Is Love (Mattias Fast Remix)
GLOBAL DEEJAYS & TECHNOTRONIK - GET UP
DEEJAY M@X - MY VALENTINE
ARTO COST & ARIAS - MAGENTA (radio edit)
ULTRAPOP & APE REGINA - THE WORLD BECAME THE WORLD
THE DISCO BOYS - WHAT YOU WANT (radio edit)
ROCKET MEN - CANDY (radio edit)
JAY FROG - Hungry Animal (Club Mix)
AUDIOPLACID - WATCH THE SUNRISE
NF PROJECT & MEIGHAN  NEALON -Picture (Nicola Fasano & Steve Forest Club Mix)
SKAM - RIGHIT IN THE NIGHT
THUNDERBOLT - TEARS LIKE RAIN
EDDIE THONEICK & BERGET LEWIS - Forgiveness (Eddie Thoneick Wildpitch Mix)
ATB - FEEL ALIVE
ROBBIEdRIVERA - FLOAT AWAY (radio edit)
TUNE BROTHERS - I See You Watching (TV Rock Remix)
PARIS AVENUE - FEEL IT (radio edit)
FREAKS - THE CREEPS
SPEKTRUM - KINDA NEW (dirty south edit)
JULIAN DJ & DAVIDE SONAR - GO GO GO
AIKON - NEW YERS DAY
MICHAEL MIND - RIDE LIKE THE WIND (radio edit)
David Vendetta Feat. Akram - Unidos Para La Musica
DJ DLG & REDROSHE &YOTA - LET YOU GO (radio edit)
ALEXANDRA PRINCE - RISING HIGH
ASBO & KATHERINE ELIS - LET THE BEAT HIT EM
IAN CAREY - Love Won't Wait (Dub Mix)
OMEGA NINE - UNIVERSAL NATION
PAUL VAN DUK & JESSIKA SUTTA
David Guetta Vs. the Egg - Love Don't Let Me Go (Walking Away) (Radio Edit)
Bob Sinclair - Yes u du
WONDRL & AVENUE - WHITE HORSE(choose in the house mix)
Steve Angello - Teasing Mr. Charlie
Route 33 - Looking back (Haji & Emmanuel mix)
MARCO G - FUNKOLICIOUS(MARION OCHOA REMIX)
Kelly llorena - Nobody like you
Sensorica ft. Jin Key - Only one (rave mix)
Ten For Two Toni Hernande - Chicago (the softer remix)
Dawn - Lovin or leavin (Benassi mix)
DJ PARMEZAN - ZOOKEY
Freeform five - No more conversations
KOSHEEN - OVERKILL
MFM PARTY MIX
DJ ANTOINE vs. PLAYER - REMADY(feat. MC ROBY ROB)
Echomen - Rain (original mix)
LEMON HIT PRES. - MART GUSHEVSKI vs. BLACK EYED PEAS
THE DRILL vs. GWEN STEFANI - DRILLABACK GIRL
DJ Ozz - Miles of life
Supermode - Tell Me Why (Simmons and Christopher remix)
Skye - Love Show (Tom Novy's Club Mix)
STYLE OF EYE - WE GOT YOU
The Drill - One more night (original mix)
SM-BOOT - IT CAN'T QUICKLY ENOUGH 192
DJ JAZZ & MC RIBLIK - LIVE AT CLUB TUSE
DIDIER SINCLAIR - FEEL THE WAVE (Original Mix)
Mauro del principe - Wade in the water
CAMILLE JONES - THE CREEPS(Fedde Le Grand Radio Mix)
Carey, Ian & Mochico - Say what you want
GOLOBAL DEEJAYS - ЗЕЛЕНОГЛАЗОЕ ТАКСИ
BODYROXA - YEAH YEAH
DAVID GUETTA - LOVE IS GONE
BASIC ELEMENT - TO YOU
ARMIN VAN BUUREN - BLUE FEAR
Erik Smax & Thomas Gold - A1 s punk
Freeloaders - So much love to give
James Holden - Nothing
Last spirit - Save me (The house keepers extended remix)
COMURN - RAZORBLADE(Malente remix)
Dominic Plaza - Sounds rushing
Beat - Kazantip 2006 (Original Mix)
Special - Summer Night
King Street - Are You Lovin Somebody (Carl Fath Remix)
Aaron Smith & Luvli - Dancin' (Thomas Gold & Eric Smax Remix)
Above And Beyond - Air For Love
Aerosoul feat. John Ward - Time Is By Your Side (Original Mix)
Afro Medusa - Pasilda (Seamus Haji & Emanuel Remix)
Alex Fain & Danny Kirsch - Holding On (Main Mix)
Alex Gaudino & Jerma pres. Lil Love - Waiting For Tonight (Extended Club Mix)
Alma Latina feat. Romina Johnson - Mas Que Nada
